                                  |
*** ***                           |
*** ***                         **|
                            ******|
************            **********|
                     *************|
                     *************|
*************        *************|
        *****        *************|
**********************************|
                                  |
                                  |
                                  |
