                                  |
*** ***                           |
*** ***         ********        **|
*******                           |
************            **********|
*                *************    |
*                *************    |
*************      ***************|
**********************************|
***********************           |
                                  |
                                  |
                                  |
